1111111111111111111111111111111111111111
1E000000000000000000000000000000000000E1
1010101010101010101010101010101010101011
1010101010101010101010101010101010101011
1010101010101010101010101010101010101011
1010101010101010101010101010101010101011
1010101010101010101010101010101010101011
1010101010101010101010101010101010101011
1010101010101010101010101010101010101011
1C1C1C1C1C1C1C1C1C1C1C1C1C1C1C1C1C1C1C11
1010101010101010101010101010101010101011
1010101010101010101010101010101010101011
1010101010101010101010101010101010101011
1010101010101010101010101010101010101011
1010101010101010101010101010101010101011
1010101010101010101010101010101010101011
1010101010101010101010101010101010101011
1010101010101010101010101010101010101011
1E000000000000000000000000000000000000P1
1111111111111111111111111111111111111111
