1111111111111
1E00C000C00E1
100C0C0C0C001
10C000C000C01
10C000P000C01
100C00000C001
1000C000C0001
10000C0C00001
1E0000C0000E1
1111111111111
