1111111111
1C000000C1
1000000001
1000000001
1000P00001
1000000001
1000000001
1000000001
11000000E1
1111111111
