1111111111111111111
100000000C000000001
10P000000C000000001
100000000C000000001
100000000C000000001
100000000C000000001
100000000C000000001
1CCCCCCCCECCCCCCCC1
100000000C000000001
100000000C000000001
100000000C000000001
100000000C000000001
100000000C000000001
100000000C000000001
1111111111111111111
