11111111111111111
1C0000000000000C1
10000000000000001
10000000000000001
100000000P0000001
10000000000000001
10000000000000001
100000000000000E1
11111111111101111
