11111111111111111
1C0000000000000C11
1000000000000000111
10000000000000001111
10000000P000000011111
10000000000000001111
1000000000000000111
100000000000000E11
11111111111111111
