11111111111111111
1C0000000000000C1
1000 HELLO 000001
10000000000000001
10000000P00000001
10000000000000001
1000 WORLD 000001
100000000000000E1
11111111111111111
