11111111111111111
1C0000000000000C1
10000000000000001
10000000000000001
10000000P00000001
10000000000000001
10000000000000001
10000000000000001
11111111111111111
